mcList
downstairs
END
itemList
elle
banana
END
transList
map1,17,4
basement,3,3
END
102, 102, 102, 102, 102, 102, 102, 102, 102, 102, 102
102, 001, 1201, 001, 001, 001, 001, 001, 102, 1301.0, 102
105, 001, 001, 001, 001, 001, 001, 001, 001, 001, 105
102, 001, 001, 001, 1201, 001, 001, 001, 001, 001, 102
105, 001, 001, 1201, 001, 001, 001, 001, 001, 001, 105
102, 001, 001, 001, 001, 001, 001, 001, 001, 001, 102
105, 001, 001, 001, 001, 001, 001, 001, 001, 001, 105
102, 102, 102, 102, 102, 301, 102, 102, 102, 102, 102
END
source
floor
END

