mcList
warp
foofhouse
END
itemList
elle
banana
END
transList
map2,2,10
foofhouse,5,6
END
115, 008, 013, 013, 013, 013, 013, 013, 013, 013, 013, 013, 013, 013, 013, 013, 013, 013, 013, 013, 013
010, 005, 013, 013, 013, 013, 013, 013, 013, 000, 009, 009, 001, 013, 013, 113.1, 113, 113, 113, 113, 013
013, 013, 013, 013, 013, 013, 013, 013, 000, 007, 115, 115, 008, 013, 013, 113, 113, 113, 113, 113, 013
013, 000, 009, 009, 001, 013, 013, 013, 011, 115, 215, 002, 005, 013, 013, 113, 113, 1313, 113, 113, 013
013, 011, 115, 115, 008, 013, 013, 013, 004, 003, 115, 008, 013, 013, 013, 013, 013, 013, 013, 013, 013
013, 011, 115, 115, 006, 009, 001, 013, 013, 004, 010, 005, 013, 013, 013, 013, 013, 013, 013, 013, 013
013, 004, 003, 115, 115, 115, 008, 013, 013, 013, 013, 013, 013, 013, 013, 013, 013, 013, 013, 013, 013
013, 000, 007, 115, 115, 115, 008, 013, 013, 313.0, 013, 013, 013, 013, 013, 000, 009, 009, 001, 013, 013
013, 011, 115, 115, 115, 115, 008, 013, 013, 013, 013, 013, 013, 013, 013, 011, 115, 115, 008, 013, 013
013, 004, 010, 010, 010, 010, 005, 013, 013, 013, 013, 013, 013, 013, 000, 007, 115, 115, 008, 013, 013
013, 013, 013, 013, 013, 013, 013, 013, 013, 013, 013, 013, 013, 013, 011, 115, 115, 002, 005, 013, 013
013, 013, 013, 013, 013, 013, 013, 013, 013, 013, 013, 013, 000, 009, 007, 115, 002, 005, 013, 013, 013
013, 013, 213, 013, 013, 013, 013, 013, 013, 013, 013, 013, 011, 115, 115, 115, 008, 013, 013, 013, 013
013, 013, 013, 013, 013, 013, 013, 013, 1200, 009, 001, 013, 004, 010, 010, 010, 005, 013, 013, 013, 013
013, 013, 013, 013, 013, 013, 013, 013, 011, 115, 008, 013, 013, 013, 013, 013, 013, 013, 013, 013, 013
013, 013, 013, 013, 013, 013, 013, 013, 004, 010, 005, 013, 013, 013, 013, 013, 013, 013, 013, 013, 013
END
source
tile
END